EA ./textures/east.xpm
SO ./textures/south.xpm
WE ./textures/west.xpm
NO ./textures/north.xpm

F 100,100,100

C 200,200,200

1111111111111111111111111111111111111111111111111
1111111111111100111111101111111001111111111111111
1111111111111110011111101111110011111111111111111
1111111111111111001111101111100111111111111111111
1111111111111111100111101111001111111111111111111
1111111111111111110011101110011111111111111111111
1111111111111111111001101100111111111111111111111
1111111111111111111100000001111111111111111111111
1000000000000000000000000000000000000000000000001
10000000000000000000000S0000000000000000000000001
1000000000000000000000000000000000000000000000001
1111111111111111111100000001111111111111111111111
1111111111111111111001101100111111111111111111111
1111111111111111110011101110011111111111111111111
1111111111111111100111101111001111111111111111111
1111111111111111001111101111100111111111111111111
1111111111111110011111101111110011111111111111111
1111111111111100111111101111111001111111111111111
1111111111111001111111101111111100111111111111111
1111111111111111111111111111111111111111111111111