EA ./textures/east.xpm
SO ./textures/south.xpm
WE ./textures/west.xpm

NO ./textures/north.xpm

F 100,100,100

C 200,200,200

1111111111111111111111111111111111
1E00000000000000000000000000000001
1111111111111111111111111111111111
