EA ./path_to_the_east_texture.xpm
SO ./path_to_the_south_texture.xpm
WE ./path_to_the_west_texture.xpm
NO ./path_to_the_north_texture.xpm

F 100,100,100
C 200,200,200

1111111111111111111111111
1N000000000000000000000001
1111111111111111111111101
1000000000000000000000101
1011111111111111111110101
1010000000000000000010101
1010111111111111111010101
1010100000000000001010101
1010101111111111101010101
1010101000000000101010101
1010101011111110101010101
1010101010000010101010101
1010101010111010101010101
1010101010100010101010101
1010101010101110101010101
1010101010101000101010101
1010101010101011101010101
1010101010101010001010101
1010101010101010111010101
1010101010101010100010101
1010101010101010111110101
1010101010101000000000101
1010101010111111111111101
1010101000000000000000001
1010111111111111111111111
1000000000000000000000001
1111111111111111111111111
