EA ./textures/east2.xpm
SO ./textures/south2.xpm
WE ./textures/west2.xpm
NO ./textures/north2.xpm
F 220,100,1
C 225,30,255

1111111111111111111111111
1000000000110000000000001
1011000001110000000000001
100100000000000000000000111111111
111111111011000001110000000000001
100000000011000001110111111111111
11110111111111011100000010001
11110111111111011101010010001
1100000011010101110000000001
1000000000000001100000010001
10000000000000001101010010001
110000011101010111111111N0111
11110111 1110101 101111010001
11111111 1111111 111111011111
